

NO:                          ana-a
SN:                          asa-a



F:          666



W:                          waa-a

E:                          aea-a





C: dddd


       11111