1111111
1C1P0E1
1000111
10000C1
1111111